!LAD:
! Reroute hms hodo data through LAD class
! LLADSCIN_ID= 33   ADC+,ADC-,TDC+,TDC-

DETECTOR=33

ROC=1

!SLOT=18
!REFINDEX=3
! chan    plane     bar    sig
!     11,   1000,      0,     3!  lFADC_TREF_ROC1

! F250 modules
SLOT=3
!REFINDEX=3
! chan   plane     bar     sig
        0,       1,      1,      0!    l1x01A+
        1,       1,      2,      0!    l1x02A+
        2,       1,      3,      0!    l1x03A+
        3,       1,      4,      0!    l1x04A+
        4,       1,      5,      0!    l1x05A+
        5,       1,      6,      0!    l1x06A+
        6,       1,      7,      0!    l1x07A+
        7,       1,      8,      0!    l1x08A+
        8,       1,      9,      0!    l1x09A+
        9,       1,     10,      0!    l1x10A+
        10,      1,     11,      0!    l1x11A+
        11,      2,      1,      0!    l2x01A+
        12,      2,      2,      0!    l2x02A+
        13,      2,      3,      0!    l2x03A+
        14,      2,      4,      0!    l2x04A+
        15,      2,      5,      0!    l2x05A+
        16,      2,      6,      0!    l2x06A+
        17,      2,      7,      0!    l2x07A+
        18,      2,      8,      0!    l2x08A+
        19,      2,      9,      0!    l2x09A+
        20,      2,     10,      0!    l2x10A+
        21,      2,     11,      0!    l2x11A+
        22,      3,      1,      0!    l3x01A+
        23,      3,      2,      0!    l3x02A+
        24,      3,      3,      0!    l3x03A+
        25,      3,      4,      0!    l3x04A+
        26,      3,      5,      0!    l3x05A+
        27,      3,      6,      0!    l3x06A+
        28,      3,      7,      0!    l3x07A+
        29,      3,      8,      0!    l3x08A+
        30,      3,      9,      0!    l3x09A+
        31,      3,     10,      0!    l3x10A+
        32,      3,     11,      0!    l3x11A+
        33,      4,      1,      0!    l4x01A+
        34,      4,      2,      0!    l4x02A+
        35,      4,      3,      0!    l4x03A+
        36,      4,      4,      0!    l4x04A+
        37,      4,      5,      0!    l4x05A+
        38,      4,      6,      0!    l4x06A+
        39,      4,      7,      0!    l4x07A+
        40,      4,      8,      0!    l4x08A+
        41,      4,      9,      0!    l4x09A+
        42,      4,     10,      0!    l4x10A+
        43,      4,     11,      0!    l4x11A+
        44,      5,      1,      0!    l5x01A+
        45,      5,      2,      0!    l5x02A+
        46,      5,      3,      0!    l5x03A+
        47,      5,      4,      0!    l5x04A+
        48,      5,      5,      0!    l5x05A+
        49,      5,      6,      0!    l5x06A+
        50,      5,      7,      0!    l5x07A+
        51,      5,      8,      0!    l5x08A+
        52,      5,      9,      0!    l5x09A+
        53,      5,     10,      0!    l5x10A+
        54,      5,     11,      0!    l5x11A+

! F250 modules
SLOT=4
!REFINDEX=3
! chan   plane     bar     sig
        0,       1,      1,      1!    l1x01A-
        1,       1,      2,      1!    l1x02A-
        2,       1,      3,      1!    l1x03A-
        3,       1,      4,      1!    l1x04A-
        4,       1,      5,      1!    l1x05A-
        5,       1,      6,      1!    l1x06A-
        6,       1,      7,      1!    l1x07A-
        7,       1,      8,      1!    l1x08A-
        8,       1,      9,      1!    l1x09A-
        9,       1,     10,      1!    l1x10A-
        10,      1,     11,      1!    l1x11A-
        11,      2,      1,      1!    l2x01A-
        12,      2,      2,      1!    l2x02A-
        13,      2,      3,      1!    l2x03A-
        14,      2,      4,      1!    l2x04A-
        15,      2,      5,      1!    l2x05A-
        16,      2,      6,      1!    l2x06A-
        17,      2,      7,      1!    l2x07A-
        18,      2,      8,      1!    l2x08A-
        19,      2,      9,      1!    l2x09A-
        20,      2,     10,      1!    l2x10A-
        21,      2,     11,      1!    l2x11A-
        22,      3,      1,      1!    l3x01A-
        23,      3,      2,      1!    l3x02A-
        24,      3,      3,      1!    l3x03A-
        25,      3,      4,      1!    l3x04A-
        26,      3,      5,      1!    l3x05A-
        27,      3,      6,      1!    l3x06A-
        28,      3,      7,      1!    l3x07A-
        29,      3,      8,      1!    l3x08A-
        30,      3,      9,      1!    l3x09A-
        31,      3,     10,      1!    l3x10A-
        32,      3,     11,      1!    l3x11A-
        33,      4,      1,      1!    l4x01A-
        34,      4,      2,      1!    l4x02A-
        35,      4,      3,      1!    l4x03A-
        36,      4,      4,      1!    l4x04A-
        37,      4,      5,      1!    l4x05A-
        38,      4,      6,      1!    l4x06A-
        39,      4,      7,      1!    l4x07A-
        40,      4,      8,      1!    l4x08A-
        41,      4,      9,      1!    l4x09A-
        42,      4,     10,      1!    l4x10A-
        43,      4,     11,      1!    l4x11A-
        44,      5,      1,      1!    l5x01A-
        45,      5,      2,      1!    l5x02A-
        46,      5,      3,      1!    l5x03A-
        47,      5,      4,      1!    l5x04A-
        48,      5,      5,      1!    l5x05A-
        49,      5,      6,      1!    l5x06A-
        50,      5,      7,      1!    l5x07A-
        51,      5,      8,      1!    l5x08A-
        52,      5,      9,      1!    l5x09A-
        53,      5,     10,      1!    l5x10A-
        54,      5,     11,      1!    l5x11A-
        

! Caen 1190 module
SLOT=1
!REFINDEX=0
  127,    1000,      0,      0!    hT2
! A0
! chan   plane     bar     sig
        0,       1,      1,      2!    l1x01T+
        1,       1,      2,      2!    l1x02T+
        2,       1,      3,      2!    l1x03T+
        3,       1,      4,      2!    l1x04T+
        4,       1,      5,      2!    l1x05T+
        5,       1,      6,      2!    l1x06T+
        6,       1,      7,      2!    l1x07T+
        7,       1,      8,      2!    l1x08T+
        8,       1,      9,      2!    l1x09T+
        9,       1,     10,      2!    l1x10T+
        10,      1,     11,      2!    l1x11T+
        11,      2,      1,      2!    l2x01T+
        12,      2,      2,      2!    l2x02T+
        13,      2,      3,      2!    l2x03T+
        14,      2,      4,      2!    l2x04T+
        15,      2,      5,      2!    l2x05T+
        16,      2,      6,      2!    l2x06T+
        17,      2,      7,      2!    l2x07T+
        18,      2,      8,      2!    l2x08T+
        19,      2,      9,      2!    l2x09T+
        20,      2,     10,      2!    l2x10T+
        21,      2,     11,      2!    l2x11T+
        22,      3,      1,      2!    l3x01T+
        23,      3,      2,      2!    l3x02T+
        24,      3,      3,      2!    l3x03T+
        25,      3,      4,      2!    l3x04T+
        26,      3,      5,      2!    l3x05T+
        27,      3,      6,      2!    l3x06T+
        28,      3,      7,      2!    l3x07T+
        29,      3,      8,      2!    l3x08T+
        30,      3,      9,      2!    l3x09T+
        31,      3,     10,      2!    l3x10T+
        32,      3,     11,      2!    l3x11T+
        33,      4,      1,      2!    l4x01T+
        34,      4,      2,      2!    l4x02T+
        35,      4,      3,      2!    l4x03T+
        36,      4,      4,      2!    l4x04T+
        37,      4,      5,      2!    l4x05T+
        38,      4,      6,      2!    l4x06T+
        39,      4,      7,      2!    l4x07T+
        40,      4,      8,      2!    l4x08T+
        41,      4,      9,      2!    l4x09T+
        42,      4,     10,      2!    l4x10T+
        43,      4,     11,      2!    l4x11T+
        44,      5,      1,      2!    l5x01T+
        45,      5,      2,      2!    l5x02T+
        46,      5,      3,      2!    l5x03T+
        47,      5,      4,      2!    l5x04T+
        48,      5,      5,      2!    l5x05T+
        49,      5,      6,      2!    l5x06T+
        50,      5,      7,      2!    l5x07T+
        51,      5,      8,      2!    l5x08T+
        52,      5,      9,      2!    l5x09T+
        53,      5,     10,      2!    l5x10T+
        54,      5,     11,      2!    l5x11T+

SLOT=2
! chan   plane     bar     sig
        0,       1,      1,      3!    l1x01T-
        1,       1,      2,      3!    l1x02T-
        2,       1,      3,      3!    l1x03T-
        3,       1,      4,      3!    l1x04T-
        4,       1,      5,      3!    l1x05T-
        5,       1,      6,      3!    l1x06T-
        6,       1,      7,      3!    l1x07T-
        7,       1,      8,      3!    l1x08T-
        8,       1,      9,      3!    l1x09T-
        9,       1,     10,      3!    l1x10T-
        10,      1,     11,      3!    l1x11T-
        11,      2,      1,      3!    l2x01T-
        12,      2,      2,      3!    l2x02T-
        13,      2,      3,      3!    l2x03T-
        14,      2,      4,      3!    l2x04T-
        15,      2,      5,      3!    l2x05T-
        16,      2,      6,      3!    l2x06T-
        17,      2,      7,      3!    l2x07T-
        18,      2,      8,      3!    l2x08T-
        19,      2,      9,      3!    l2x09T-
        20,      2,     10,      3!    l2x10T-
        21,      2,     11,      3!    l2x11T-
        22,      3,      1,      3!    l3x01T-
        23,      3,      2,      3!    l3x02T-
        24,      3,      3,      3!    l3x03T-
        25,      3,      4,      3!    l3x04T-
        26,      3,      5,      3!    l3x05T-
        27,      3,      6,      3!    l3x06T-
        28,      3,      7,      3!    l3x07T-
        29,      3,      8,      3!    l3x08T-
        30,      3,      9,      3!    l3x09T-
        31,      3,     10,      3!    l3x10T-
        32,      3,     11,      3!    l3x11T-
        33,      4,      1,      3!    l4x01T-
        34,      4,      2,      3!    l4x02T-
        35,      4,      3,      3!    l4x03T-
        36,      4,      4,      3!    l4x04T-
        37,      4,      5,      3!    l4x05T-
        38,      4,      6,      3!    l4x06T-
        39,      4,      7,      3!    l4x07T-
        40,      4,      8,      3!    l4x08T-
        41,      4,      9,      3!    l4x09T-
        42,      4,     10,      3!    l4x10T-
        43,      4,     11,      3!    l4x11T-
        44,      5,      1,      3!    l5x01T-
        45,      5,      2,      3!    l5x02T-
        46,      5,      3,      3!    l5x03T-
        47,      5,      4,      3!    l5x04T-
        48,      5,      5,      3!    l5x05T-
        49,      5,      6,      3!    l5x06T-
        50,      5,      7,      3!    l5x07T-
        51,      5,      8,      3!    l5x08T-
        52,      5,      9,      3!    l5x09T-
        53,      5,     10,      3!    l5x10T-
        54,      5,     11,      3!    l5x11T-