!LAD:
! LSCIN_ID= 33   ADC+,ADC-,TDC+,TDC-

DETECTOR=33

ROC=1
        
! FADC 250 module
SLOT=3
! chan   plane     bar     sig
        0,       1,      1,      0!    l1x01T+
        1,       1,      2,      0!    l1x02T+
        2,       1,      3,      0!    l1x03T+
        3,       1,      4,      0!    l1x04T+
        4,       1,      5,      0!    l1x05T+
        5,       1,      6,      0!    l1x06T+
        6,       1,      7,      0!    l1x07T+
        7,       1,      8,      0!    l1x08T+
        8,       1,      1,      1!    l1x01T-
        9,       1,      2,      1!    l1x02T-
        10,      1,      3,      1!    l1x03T-
        11,      1,      4,      1!    l1x04T-
        12,      1,      5,      1!    l1x05T-
        13,      1,      6,      1!    l1x06T-
        14,      1,      7,      1!    l1x07T-
        15,      1,      8,      1!    l1x08T-