!LAD:
! LLADSCIN_ID= 33   ADC+,ADC-,TDC+,TDC-

DETECTOR=33

ROC=9

! F250 modules
SLOT=14
! chan   plane     bar     sig
        0,       1,      1,      1!    l1x01A-
        1,       1,      2,      1!    l1x02A-
        2,       1,      3,      1!    l1x03A-
        3,       1,      4,      1!    l1x04A-
        4,       1,      5,      1!    l1x05A-
        5,       1,      6,      1!    l1x06A-
        6,       1,      7,      1!    l1x07A-
        7,       1,      8,      1!    l1x08A-
        8,       1,      1,      0!    l1x01A+
        9,       1,      2,      0!    l1x02A+
        10,      1,      3,      0!    l1x03A+
        11,      1,      4,      0!    l2x04A+
        12,      1,      5,      0!    l2x05A+
        13,      1,      6,      0!    l2x06A+
        14,      1,      7,      0!    l2x07A+
        15,      1,      8,      0!    l2x08A+

SLOT=15
! chan   plane     bar     sig
        0,       1,      9,      1!    l1x09A-
        1,       1,     10,      1!    l1x10A-
        2,       1,     11,      1!    l1x11A-
        3,       2,      1,      1!    l2x01A-
        4,       2,      2,      1!    l2x02A-
        5,       2,      3,      1!    l2x03A-
        6,       2,      4,      1!    l2x04A-
        7,       2,      5,      1!    l2x05A-
        8,       1,      9,      0!    l1x09A+
        9,       1,     10,      0!    l1x10A+
        10,      1,     11,      0!    l1x11A+
        11,      2,      1,      0!    l2x01A+
        12,      2,      2,      0!    l2x02A+
        13,      2,      3,      0!    l2x03A+
        14,      2,      4,      0!    l2x04A+
        15,      2,      5,      0!    l2x05A+

SLOT=16
! chan   plane     bar     sig
        0,       2,      6,      1!    l2x06A-
        1,       2,      7,      1!    l2x07A-
        2,       2,      8,      1!    l2x08A-
        3,       2,      9,      1!    l2x09A-
        4,       2,     10,      1!    l2x10A-
        5,       2,     11,      1!    l2x11A-
        6,       3,      1,      1!    l3x01A-
        7,       3,      2,      1!    l3x02A-
        8,       2,      6,      0!    l2x06A+
        9,       2,      7,      0!    l2x07A+
        10,      2,      8,      0!    l2x08A+
        11,      2,      9,      0!    l2x09A+
        12,      2,     10,      0!    l2x10A+
        13,      2,     11,      0!    l2x11A+
        14,      3,      1,      0!    l3x01A+
        15,      3,      2,      0!    l3x02A+


SLOT=17
! chan   plane     bar     sig
        0,       3,      3,      1!    l3x03A-
        1,       3,      4,      1!    l3x04A-
        2,       3,      5,      1!    l3x05A-
        3,       3,      6,      1!    l3x06A-
        4,       3,      7,      1!    l3x07A-
        5,       3,      8,      1!    l3x08A-
        6,       3,      9,      1!    l3x09A-
        7,       3,     10,      1!    l3x10A-
        8,       3,      3,      0!    l3x03A+
        9,       3,      4,      0!    l3x04A+
        10,      3,      5,      0!    l3x05A+
        11,      3,      6,      0!    l3x06A+
        12,      3,      7,      0!    l3x07A+
        13,      3,      8,      0!    l3x08A+
        14,      3,      9,      0!    l3x09A+
        15,      3,     10,      0!    l3x10A+

SLOT=18
! chan   plane     bar     sig
        0,       3,     11,      1!    l3x11A-
        1,       4,      1,      1!    l4x01A-
        2,       4,      2,      1!    l4x02A-
        3,       4,      3,      1!    l4x03A-
        4,       4,      4,      1!    l4x04A-
        5,       4,      5,      1!    l4x05A-
        6,       4,      6,      1!    l4x06A-
        7,       4,      7,      1!    l4x07A-
        8,       3,     11,      0!    l3x11A+
        9,       4,      1,      0!    l4x01A+
        10,      4,      2,      0!    l4x02A+
        11,      4,      3,      0!    l4x03A+
        12,      4,      4,      0!    l4x04A+
        13,      4,      5,      0!    l4x05A+
        14,      4,      6,      0!    l4x06A+
        15,      4,      7,      0!    l4x07A+

SLOT=19
! chan   plane     bar     sig
        0,       4,      8,      1!    l4x08A-
        1,       4,      9,      1!    l4x09A-
        2,       4,     10,      1!    l4x10A-
        3,       4,     11,      1!    l4x11A-
        4,       5,      1,      1!    l5x01A-
        5,       5,      2,      1!    l5x02A-
        6,       5,      3,      1!    l5x03A-
        7,       5,      4,      1!    l5x04A-
        8,       4,      8,      0!    l4x05A+
        9,       4,      9,      0!    l4x06A+
        10,      4,     10,      0!    l4x10A+
        11,      4,     11,      0!    l4x11A+
        12,      5,      1,      0!    l5x01A+
        13,      5,      2,      0!    l5x02A+
        14,      5,      3,      0!    l5x03A+
        15,      5,      4,      0!    l5x04A+

SLOT=20
! chan   plane    bar     sig
        0,       5,      5,      1!    l5x05A-
        1,       5,      6,      1!    l5x06A-
        2,       5,      7,      1!    l5x07A-
        3,       5,      8,      1!    l5x08A-
        4,       5,      9,      1!    l5x09A-
        5,       5,     10,      1!    l5x10A-
        6,       5,     11,      1!    l5x11A-
        8,       5,      5,      0!    l5x05A+
        9,       5,      6,      0!    l5x06A+
        10,      5,      7,      0!    l5x07A+
        11,      5,      8,      0!    l5x08A+
        12,      5,      9,      0!    l5x09A+
        13,      5,     10,      0!    l5x10A+
        14,      5,     11,      0!    l5x11A+