################### DECODE INFO ########################################################################
## Channel maps for decoding explained                                                                ##
## Each entry corresponds to one APV card                                                             ## 
## Crate = ROC ID = 2 and 4  for SBS VTP                                                              ##
## Slot = 11 for BigBite VTP                                                                          ##
## fiber/mpd is fiber number for an MPD module, this is unique for each module within a VTP/SSP       ##
## gemid is unique "production ID" of a GEM module, not currently used by analysis but useful         ##
## for bookkeeping/tracking                                                                           ##
## adc_ch is the unique adc channel of this APV card within its associated MPD                        ##
## i2c is the "i2c address" of this APV card (not currently used by analysis)                         ##
## pos maps APV cards to physical locations on the detector                                           ##
## invert specifies whether strip index runs from "right-to-left" or "left-to-right" within an APV    ##
## axis specifies which strip orientation/dimension of the readout strips connected to this APV       ##
## ORDER of entries in the maps is:                                                                   ##
## vtpcrate  slot  fiber  gemid  adc_ch   i2c   pos     invert   axis                              ##
########################################################################################################
# Chanmap for hall

#Crate slot fiber  GEMID  ADCId   I2C    Pos    Invert   axis
#============================= Crate_11 Layer_4 GEM_0 ==================
lgem_m0_chanmap = 
11     11       1     0     0      15    23      1     1      
11     11       1     0     1      14    22      1     1  
11     11       1     0     2      13    21      1     1  
11     11       1     0     3      12    20      1     1  
11     11       1     0     4      11    19      1     1  
11     11       1     0     5      10    18      1     1  
11     11       1     0     6      9     17      1     1  
11     11       1     0     7      8     16      1     1  
11     11       1     0     8      7     15      1     1  
11     11       1     0     9      6     14      1     1  
11     11       1     0     10     5     13      1     1  
11     11       1     0     11     4     12      1     1  
11     11       2     0     0      15    11      1     1  
11     11       2     0     1      14    10      1     1  
11     11       2     0     2      13     9      1     1  
11     11       2     0     3      12     8      1     1  
11     11       2     0     4      11     7      1     1  
11     11       2     0     5      10     6      1     1  
11     11       2     0     6      9      5      1     1  
11     11       2     0     7      8      4      1     1  
11     11       2     0     8      7      3      1     1  
11     11       2     0     9      6      2      1     1  
11     11       2     0     10     5      1      1     1  
11     11       2     0     11     4      0      1     1  
#-----------------------------------------------------------------------
11     11       0     0     1      4      0      0      0   
11     11       0     0     2      5      1      0      0    
11     11       0     0     3      6      2      0      0    
11     11       0     0     4      7      3      0      0    
11     11       0     0     5      8      4      0      0    
11     11       0     0     6      9      5      0      0    
11     11       0     0     7      10    11      0      0   
11     11       0     0     8      15    10      1      0  
11     11       0     0     9      14     9      1      0   
11     11       0     0     10     13     8      1      0   
11     11       0     0     11     12     7      1      0  
11     11       0     0     12     11     6      1      0 
#
##################    LAD Chamber (far)    ##################
lgem_m1_chanmap = 
11     11        4     2     0      15    12      0      1
11     11        4     2     1      14    13      0      1
11     11        4     2     2      13    14      0      1
11     11        4     2     3      12    15      0      1
11     11        4     2     4      11    16      0      1
11     11        4     2     5      10    17      0      1
11     11        4     2     6      9     18      0      1
11     11        4     2     7      8     19      0      1
11     11        4     2     8      7     20      0      1
11     11        4     2     9      6     21      0      1
11     11        4     2     10     5     22      0      1
11     11        4     2     11     4     23      0      1
11     11        5     2     0      15     0      0      1
11     11        5     2     1      14     1      0      1
11     11        5     2     2      13     2      0      1
11     11        5     2     3      12     3      0      1
11     11        5     2     4      11     4      0      1
11     11        5     2     5      10     5      0      1
11     11        5     2     6      9      6      0      1
11     11        5     2     7      8      7      0      1
11     11        5     2     8      7      8      0      1
11     11        5     2     9      6      9      0      1
11     11        5     2     10     5     10      0      1
11     11        5     2     11     4     11      0      1
#----------------------------------------------------------------------
11     11        3     2     1      4       0      0      0
11     11        3     2     2      5       1      0      0
11     11        3     2     3      6       2      0      0
11     11        3     2     4      7       3      0      0
11     11        3     2     5      8       4      0      0
11     11        3     2     6      9       5      0      0
11     11        3     2     7      10     11      0      0
11     11        3     2     8      15     10      1      0
11     11        3     2     9      14      9      1      0
11     11        3     2     10     13      8      1      0
11     11        3     2     11     12      7      1      0
11     11        3     2     12     11      6      1      0